English grammar

Sentence -> Subject Verb Object
Subject -> Pronoun 
Pronoun -> I | you | he | she | it | …
Verb ->  went | ate | ran | …
Object -> Preposition Article Noun
Preposition -> to | beside | under | ….
Article ->  the | at | under | …
Noun -> movies | races | restaurant | …


NT   = (Sujeto, Verbo, Conector, Sustantivo)
Terminales  = (ya, ty,...)

S -> Oracion ST

Oracion -> OracionAdjetivo |
	   OracionConector |
	   Sujeto VP |
	   VP

OracionConector -> Sujeto Conector |
		   Sujeto Adjetivo Conector 

OracionAdjetivo -> Sujeto Adjetivo AdjT

AdjT -> Continuacion | ε

Continuacion -> VP | Oracion ST

VP -> 	Verbo VPT |
	Adverbio Verbo VPT

VPT -> Sustantivo | Preposicion Sustantivo | ε

Sustantivo -> 	Adjetivo Sustantivo |
		Sustantivo Conector |

ST -> Conector Oracion ST | ε 		(La oración puede terminar con un conector o en ε)

Sujeto ->ya | ty | on | ona | my | oni
Verbo -> lyublyu | zhivu | khochu | uchus’ | vizhu | 
Conector -> i | ili | no | potomu chto | khotya | togda | yesli | tozhe
Sustantivo -> papa | mama | kot | sobaka | dom | shkola | drug | lyubov
Preposicion -> v | na | s | bez | dlya | k | iz
Adverbio → bystro | medlenno | vsegda | nikogda | inogda | segodnya | vchera | khorosho | plokho | mnogo | malo
Adjetivo → bolshoy | krasivaya | nekrasivyy | novyy | staryy | umnyy | sil'nyy | slabyy | khoroshiy | plokhoy | chornyy | belyy | krasnyy | malen’kiy | bystryy | medlennyy